____________________________
______###################___
______#_____________________
______#___###############___
______#___#_________________
______#########1########____
__________#____________>###_
__________##############__#_
__________________________2_
_______######3######______#_
_______#___________#______#_
_######<___________>#######_
_#_____#___________#________
_#_____#############________
_#__________________________
_#_####################_____
_##<________________________
___####################_____
____________________________