................
....#######.....
.####.....#####.
....#######...#.
..............#.
..######......#.
..#....#......#.
..#############.
.......#........
.......#........
.......#........