...............
....#######....
.####.....####.
.#..#######..#.
.#...........#.
.#############.
...............