............................
......###################...
......#.....................
......#...###############...
......#...#.................
......##################....
..........#............>###.
..........##############..#.
..........................#.
.......#############......#.
.......#...........#......#.
.######>...........<#######.
.#.....#...........#........
.#.....#############........
.#..........................
.#.####################.....
.##<........................
...####################.....
............................