// = comment

// ░, " " = Air
// ═, ║, ╔, ╚, ╗, ╝, ╬ = Track (all are IDENTICAL)
// ╠ = Switch connecting UP, BOTTOM, RIGHT
// ╣ = Switch connecting UP, BOTTOM, LEFT 

░░░░░░░░░░░░░░░░░░░░░░░░░░░░
░░░░░░╔══════════════════░░░
░░░░░░║░░░░░░░░░░░░░░░░░░░░░
░░░░░░║░░░╔══════════════░░░
░░░░░░║░░░║░░░░░░░░░░░░░░░░░
░░░░░░╚═══╬════1═══════╗░░░░
░░░░░░░░░░║░░░░░░░░░░░░╠══╗░
░░░░░░░░░░╚════════════╝░░║░
░░░░░░░░░░░░░░░░░░░░░░░░░░2░
░░░░░░░╔═════3═════╗░░░░░░║░
░░░░░░░║░░░░░░░░░░░║░░░░░░║░
░╔═════╣░░░░░░░░░░░╠══════╝░
░║░░░░░║░░░░░░░░░░░║░░░░░░░░
░║░░░░░╚═══════════╝░░░░░░░░
░║░░░░░░░░░░░░░░░░░░░░░░░░░░
░║░╔═══════════════════░░░░░
░╚═╣░░░░░░░░░░░░░░░░░░░░░░░░
░░░╚═══════════════════░░░░░
░░░░░░░░░░░░░░░░░░░░░░░░░░░░
