................
.##############.
.#............#.
.##############.
.#............#.
.##############.
................