................
.###.#####......
.#.###...######.
.#............#.
.###.###......#.
.......########.
................