.........
.#######.
.#.....#.
.#.###.#.
.###.###.
.........